1111111111
1E00000001
100C000101
10100101P1
1111111111