111111111111111111111111
1E0000000000000C00000C01
100000000000000000000001
1P0001001010101000100101
101001001010101000100101
101001001C10101000100101
100000000000000000000001
10000000000000000000C001
101001001C10101000100101
10000000000000CC00010001
101001001010101000100101
100000000000000000000001
100000000C0000CC00010001
101001000C10001000100101
101001000010101000100101
100C00000000000000000001
100000000C0000CC00010001
111111111111111111111111