1111111111
1CC00000E1
100C000101
1C100101P1
1111111111