111111111111111
1EC000000000001
100000000000001
1P1001000100101
101001000100101
100000000C00001
111111111111111