111111111111111
1C1001000100101
100000000000001
100000000000001
1P10010E0100101
101001000100101
100000CC0000001
100001000000001
100C00000C00001
111111111111111