111111111111111111111111
1E0000000000000C00000C01
100000000000000000000001
1P0001001010101000100101
101001001010101000100101
101001001C10101000100101
100000000000000000000001
111111111111111111111111