111111111111111111111111
100000000000000C00000C01
100000000000000000000001
1P0001001010101000100101
1010010010101010001C0101
101001001C10101000100101
100000000000000000000001
100000000000000000000001
101001001010101000100101
101001001C10101000100101
100000000000000000000001
1000000000000000000C0001
100000000000000000000001
101001001C10101000100101
101001001C10101000100101
100000000000000E000000C1
111111111111111111111111