111111111111111
1100000000000E1
111110000001111
10000C0000W00P1
111111111111111